10 10
XXXXXXXXXX
XS  XXXXXX
X X  XXX X
X XX X X X
X X    X X
XXXXXXXXXX
XX  XXXX X
XXXXXXXXXX
XXXXXX  GX
XXXXXXXXXX